Name: Programming Languages
Vincent M Aquila: python,
Habtamu H Asfaw: nodejs
Kyle  Barry: python,
Jackie  Cao: R, python
Guy Chiu-Kai Chan: python, fortran,
Zachary A Connaughton (Zach): python, VBA, Java,
Zach Russell  Cooper: python, SQL, html, css
Daniel Andrew Cornutt (Dan): python, java, VBA
Manmeet S Dosanjh: SQL, python
Carol Louise  Farris: Javascript, html, css
Parastoo  Javadi: python
Jim Jenkins: basic,
Jae Kim: powershell,
Jugal Kishore: basic, C++, C,
Kathryn Claire  Koehn (Kate): Python,
Cheng Liu: SQL, Python, javascript, html
Zidan Luo: java, SAS, matlab
Yaovi Metemey (obed): SQL, Python,
Maxwell Morelly: python, html, javascript
Adolphe Aime  Ndilingiye: java,
An T  Nguyen (Fyfy): SQL,
Thanh H Nhan: C#, ASP.net
Brian E Nisonger: perl, C, SQL
Timothy J Pauley: C#, scala, Java, javascript
Austen  Rawle: javascript, ruby, .net, java
Jon Serpas: python, bash, SQL, javascript
Kannappan Sethunarayanan (kanahn): python, java
Drew A  Smith: C# ASP.net, SQL javascript
Lance Streit (Eric): bash, powershell
Ronald Frank  Tallman: bash
Dianna  Tingg: python, java
Udo (Michael) Uduhiri: python, html, javascript
